NO ./textures/north.xpm
SO ./textures/south.xpm
WE ./textures/west.xpm
EA ./textures/east.xpm


F 0,0,0
C 25,255,255


1111111111111111111111111111111111
1000000000000000000000000000000000011111
100000W000000000000000001111111111011111
111111111100000000000000000000000011111
100000000000000111111000000000111111111
1111111111111111111110001111110000001111
1111111111111111111110001111110000001111
1111111111111111111111000000000000011111
1111111111111111111111100000000000000001
1111111111111111111111111111111111111111
