NO ./textures/7sB6yU3.xpm
SO ./textures/grunge-brick-wall-background-_1_.xpm
WE ./textures/rock-wall-256x256.xpm
EA ./textures/brick-wall-background-texture-_1_.xpm

F 0,0,0
C 0,50,50

111111111111111111111111111111111111111111111111111111111
110000000000000000001111000000000000000000000000000000001
110011110000000000111111000000000000000000000000110000001
110000110000000000000000000000000000000000000000110000001
110011110000000000111111000000000000000000000000110000001
110000000000000000001111000000000011111100111111110000001
111111110011111111111111111100111111000000000000110000001
111111110011111111111111111100111111001100110000110000001
111100000000000011110011001100111111000000000000110000001
110000000000000000000000000000001111000000000000110000001
110000000000000000000000000000001111000000110000000000001
111100000000000011110011001100000000000000000000000000001
111111110011111111110011001100000000000000000000000000001
110000000000000000001111000000000011000000000000110000001
110000000000000000000000000000000000000000000000001100001
110000000000000000001100000000110000000000000000001100001
1100000000000000000011110011000000000000E0000000000000001
110000000000000000000011000000000000001100110000000000001
111111111111111111111111111111111111111111111111111111111