NO ./textures/north.xpm
SO ./textures/south.xpm
WE ./textures/west.xpm
EA ./textures/east.xpm

F 65,249,4
C 169,85,12

    111111111111111
 11111100001111111
      1000N1001111
111111100000001
111111111111011
           101
           111