        111111111111111111111111111111111111111111111111111111111111111111111111111111111111
        100000000011000000000000000000000000000000000000000000000000000000000000000011111111
        101100000111000000000000000000000000000000000000000000000000000000000000000000000001
        100100000000000000000000000000000000000000000000000000000000000000000000000000000001
11111111101100000111000000000000000000000000000000000000000000000000000000000000000000000001
10000000001100000111011111111111111111111111111111111111111111111111111111111111111111111111
1111011111111101110000000000000000000000000000000000000000000000000000000000000000010001
1111011111111101110101000000000000000000000000000000000000000000000000000000000000010001
1100000011010101110000000000000000000000000000000000000000000000000000000000000000010001
1000000000000000110000000000000000000000000000000000000000000000000000000000000000010001
1000000000000000110000000000000000000000000000000000000000000000000000000000000000010001
1000000000000000110000000000000000000000000000000000000000000000000000000000000000010001
1000000000000000110000000000000000000000000000000000000000W00000000000000000000000010001
1000000000000000110000000000000000000000000000000000000000000000000000000000000000010001
1000000000000000110000000000000000000000000000000000000000000000000000000000000000010001
1000000000000000110000000000000000000000000000000000000000000000000000000000000000010001
1000000000000000110000000000000000000000000000000000000000000000000000000000000000010001
1000000000000000110000000000000000000000000000000000000000000000000000000000000000010001
1000000000000000110000000000000000000000000000000000000000000000000000000000000000010001
1000000000000000110000000000000000000000000000000000000000000000000000000000000000010001
1000000000000000110000000000000000000000000000000000000000000000000000000000000000010001
1000000000000000110000000000000000000000000000000000000000000000000000000000000000010001
1000000000000000110000000000000000000000000000000000000000000000000000000000000000010001
1000000000000000110000000000000000000000000000000000000000000000000000000000000000010001
1000000000000000110000000000000000000000000000000000000000000000000000000000000000010001
1000000000000000110000000000000000000000000000000000000000000000000000000000000000010001
1000000000000000110000000000000000000000000000000000000000000000000000000000000000010001
1000000000000000110000000000000000000000000000000000000000000000000000000000000000010001
1000000000000000110000000000000000000000000000000000000000000000000000000000000000010001
1000000000000000110000000000000000000000000000000000000000000000000000000000000000010001
1000000000000000110000000000000000000000000000000000000000000000000000000000000000010001
1000000000000000110000000000000000000000000000000000000000000000000000000000000000010001
1000000000000000110000000000000000000000000000000000000000000000000000000000000000010001
1000000000000000110000000000000000000000000000000000000000000000000000000000000000010001
1000000000000000110000000000000000000000000000000000000000000000000000000000000000010001
1000000000000000110000000000000000000000000000000000000000000000000000000000000000010001
1000000000000000110000000000000000000000000000000000000000000000000000000000000000010001
1000000000000000110000000000000000000000000000000000000000000000000000000000000000010001
1000000000000000110000000000000000000000000000000000000000000000000000000000000000010001
1000000000000000110000000000000000000000000000000000000000000000000000000000000000010001
1000000000000000110000000000000000000000000000000000000000000000000000000000000000010001
1000000000000000110000000000000000000000000000000000000000000000000000000000000000010001
1000000000000000110000000000000000000000000000000000000000000000000000000000000000010001
1000000000000000110000000000000000000000000000000000000000000000000000000000000000010001
1000000000000000110000000000000000000000000000000000000000000000000000000000000000010001
1000000000000000110000000000000000000000000000000000000000000000000000000000000000010001
1000000000000000110000000000000000000000000000000000000000000000000000000000000000010001
1000000000000000110000000000000000000000000000000000000000000000000000000000000000010001
1000000000000000110000000000000000000000000000000000000000000000000000000000000000010001
1000000000000000110000000000000000000000000000000000000000000000000000000000000000010001
1000000000000000110000000000000000000000000000000000000000000000000000000000000000010001
1000000000000000110000000000000000000000000000000000000000000000000000000000000000010001
1000000000000000110000000000000000000000000000000000000000000000000000000000000000010001
1000000000000000110000000000000000000000000000000000000000000000000000000000000000010001
1000000000000000110000000000000000000000000000000000000000000000000000000000000000010001
1000000000000000110000000000000000000000000000000000000000000000000000000000000000010001
1000000000000000110000000000000000000000000000000000000000000000000000000000000000010001
1000000000000000110000000000000000000000000000000000000000000000000000000000000000010001
1000000000000000110000000000000000000000000000000000000000000000000000000000000000010001
1000000000000000110000000000000000000000000000000000000000000000000000000000000000010001
1000000000000000110000000000000000000000000000000000000000000000000000000000000000010001
1000000000000000110000000000000000000000000000000000000000000000000000000000000000010001
1000000000000000110000000000000000000000000000000000000000000000000000000000000000010001
1000000000000000110000000000000000000000000000000000000000000000000000000000000000010001
1000000000000000110000000000000000000000000000000000000000000000000000000000000000010001
1000000000000000110000000000000000000000000000000000000000000000000000000000000000010001
1000000000000000110101000000000000000000000000000000000000000000000000000000000000010001
11000011101010111110111111111111111111111111111111111111111111111111111111111111111000111
11110111 1110101 10111100000000000000000000000000000000000000000000000000000000000010001
11111111 1111111 11111111111111111111111111111111111111111111111111111111111111111111111