NO ./textures/north.xpm
SO ./textures/south.xpm
WE ./textures/west.xpm
EA ./textures/east.xpm

F 3,3,3
C 255,8,58

111111111111111
100000E00000001
101111111111101
101         101
101         101
101         101
101         101
101111111111101
100000000000001
111111111111111