NO ./textures/north.xpm
SO ./textures/south.xpm
WE ./textures/west.xpm
EA ./textures/east.xpm

F
C

111111111111111
100000000000001
101111111111101
101         101
101         101
101         101
101         101
101111111111101
100000000000001
111111111111111