    1111111
11111001
1010W001
110N0111
111111