NO ./textures/north.xpm
SO ./textures/south.xpm
WE ./textures/west.xpm
EA ./textures/east.xpm

F 0,0,0
C 101,22,132

11111111
100N0001
10000001
1111110111111
    100000001
    111111111