    1111111
11111001
1010W001
11000111
111111