11111 11
10010001
10100001
1100N111
111111