NO ./textures/north.xpm
SO ./textures/south.xpm
WE ./textures/west.xpm
EA ./textures/east.xpm

F 152,59,45
C 101,22,132

11111
10W01
10001
11111