    111111111111111
 11110000000111111
 11000N0001111
11100000000001
11111111111101
           101
           111