    111111111111111
 11111100001111111
      1000N1001111
111111100000001
11111111111101
           101
           111