11111111111111
11100000001111
  1000N0000   
11100000001111
11111111111111