NO ./textures/game_texture.xpm
SO ./textures/green_wall.xpm
WE ./textures/purple_wall.xpm
EA ./textures/color_wall.xpm

F 0,0,0
C 101,22,132

        111111111111111111
        100D001000110000011111111
        1011000101110000000000001
        10010000000D0000000000001
111111111011110001110000000000001
100000000011000001110111111111111
11110111111111011100000010001
1111D111111111011101010010001
11000000110101011100000010001
1000B000000000001100000010001
1000000000100E00D001010000001
1100000111110101111101111000111
11110111 1110101 101111010001
11111111 1111111 111111111111