NO ./textures/game_texture.xpm
SO ./textures/green_wall.xpm
WE ./textures/purple_wall.xpm
EA ./textures/color_wall.xpm

F 0,0,0
C 101,22,132

        1111111111111111111
        1100D001000110000011111111
        11011000101110000000000001
        110010000000D0000000000001
1111111111011110001110000000000001
1000000000011000001110111111111111
1000000000011000001110111111111111
111101111111111011100000010001
1111D1111111111011101010010001
110000001110101011100000010001
10B000000000000001100000010001
10000000000100E00D001010000001
11000001111110101111101111000111
11110111  1110101 101111010001
11111111  1111111 111111111111