NO ./textures/north.xpm
SO ./textures/south.xpm        
WE ./textures/west.xpm
EA ./textures/east.xpm

F 102,84,100
C 101,22,132

1111111
100S0001
10000001
1111100111111
    100B00001
    111111111