NO ./textures/north.xpm
SO ./textures/south.xpm
WE ./textures/west.xpm
EA ./textures/east.xpm

F 152,59,45
C 101,22,132

1111111111111
1000000000001
1000000000001
1000000000001
100000N000001
1111111111111