NO ./textures/game_texture.xpm
SO ./textures/green_wall.xpm
WE ./textures/purple_wall.xpm
EA ./textures/color_wall.xpm

F 0,0,0
C 101,22,132

11111111111111111111
1B0000000000000000B1
11111000000000111111
    1B000000001
    10001110B01
11111000111000111111
1B000000D0D000B000W1
11111111111111111111