NO ./textures/bluestone.xpm
SO ./textures/south.xpm
WE ./textures/west.xpm
EA ./textures/north.xpm

F 50,50,0
C 0,50,50

111111111111111111111111111111111111111111111111111111111
110000000000000000001111000000000000000000000000000000001
110011110000000000111111000000000000000000000000110000001
110000110000000000000000000000000000000000000000110000001
110011110000000000111111000000000000000000000000110000001
110000000000000000001111000000000011111100111111110000001
11111111001111111111111111111D111111000000000000110000001
111111111D11111111111111111100111111001100110000110000001
111100000000000011110011001100111111000000000000110000001
110000000000000000000000000000001111000000000000110000001
1100000000000000000000000000000011111111D1110000000000001
1111000000000000111100110011000B00000000B0000000000000001
111111110011111111110011001100000000000000000000000000001
1100000000000000000011110000000000110000N0000000110000001
110000000000000000000000000000000000000000000000001100001
110000000000000000001100000000110000B00000000000001100001
110000000000000000001111001100000000000000000000000000001
1100000000000000000000110000000B0000001100110000000000001
111111111111111111111111111111111111111111111111111111111